location	entity在什么位置	entity在哪儿	where
type	entity的类型是什么	entity属于什么类型	what
title	entity的头衔是什么	entity具有哪些头衔	what
birthPlace	entity的出生地是哪里	entity在什么地方出生的	where
subdivisionName	entity的所属区域是什么	entity在哪个区域	where
predecessor	entity的前一任是谁	entity是谁的继任者	who
successor	entity的继任者是哪位	entity是谁的上一任	who
region	entity所属的国家区域是哪里	entity在国内属于什么区域	where
caption			
before	entity的前任是什么	entity的上一代是什么	what
city	entity所属城市是哪里	entity在哪个城市	where
country	entity的所属国家是什么	entity在哪个国家	where
religion	entity的信仰宗教是什么	entity信仰哪个宗教	what
after	entity的继任者是哪位	entity是谁的上一任	who
subdivisionType	entity的区划是什么	entity属于哪个区划	where
spouse	entity的配偶是哪位	entity的配偶是谁	who
timezone	entity用什么时区	entity属于哪个时区	what
language	entity用什么语言交流	entity说什么语言	what
capital	entity的首都（或省会）是哪里	entity的首都（或省会）在哪儿	where
owner	entity的总裁是谁	entity的拥有者是谁	who
founder	entity的创始人是谁	entity是谁创始的	who
genre	entity的类型是什么	entity是什么类型的	what
occupation	entity的职业是什么	entity是做什么职业的	what
leader	entity的领导人是谁	entity是谁领导的	who
party	entity所属的党派是什么	entity属于哪个党派	what
state	entity所在的州是哪里	entity在哪个州	where
deathPlace	entity逝世的地方是哪里	entity在哪里逝世的	where
almaMater	entity的母校是什么	entity的母校叫什么	what
province	entity的所在的省份是哪里	entity在哪个省	where
leaderName	entity领导人的名字是	entity的领导人叫什么	who
leaderTitle	entity领导人的头衔是什么	entity领导人的头衔有哪些	what
office	entity就职的地方是哪里	entity在哪里就职	what
president	entity效力的总统是谁	entity为哪个总统效力	who
nationality	entity的国籍是什么	entity是哪个国家的	what
father	entity的父亲是谁	entity的爸爸是谁	who
position	entity的定位是什么	entity有什么定位	what
headquarters	entity的总部在哪里	entity的总部地址是哪里	where
products	entity的产品是什么	entity有什么产品	what
imageCaption	entity的代表是什么	entity有什么代表	what
industry	entity的所属产业是什么	entity属于什么产业	what
cityofbirth	entity的出生城市在哪里	entity在哪个城市出生的	where
seat	entity的行政中心在哪里	entity的省会是哪里	where
timezoneDst	entity的时区是什么	entity属于哪个时区	what
knownFor	entity的成名作是什么	entity有什么成名作	what
eventEnd	entity的结局是什么	entity以什么结局	what
governmentType	entity的国家体制是什么	entity采用哪种国家体制	what
namedAfter	entity的名字来自哪里	entity的名字来源于哪里	what
placeOfBirth	entity的出生地在哪里	entity在哪里出生的	where
parent	entity属于哪个	entity的父类是什么	what
league	entity效力的联赛是哪个	entity效力于哪个联赛	what
territory	entity是哪个地区的	entity的地区是什么	what
timezone1Dst	entity的时区是什么	entity属于哪个时区	what
arrondissement	entity是哪个区的	entity的属于哪个区	what
operator	entity的运营方是谁	entity是由谁运营的	who
house	entity所属的王朝是什么	entity属于哪个王朝	what
settlementType	entity的地区类型是什么	entity属于哪个地区类型	what
label	entity属于什么标签	entity的标签什么	what
residence	entity的居住地在哪里	entity住过的地方有哪些	where
mother	entity的母亲是谁	entity的妈妈叫什么	who
place	entity的地址在哪里	entity在哪里发生的	where
eponym	entity的命名者是谁	entity是以谁命名的	who
author	entity的作者是谁	entity是谁写的	who
canton	entity的驻地在哪儿	entity在哪儿驻地	where
event	entity发生的事件	entity发生过什么	what
companyType	entity的公司类型是什么	entity是什么类型的公司	what
related	同entity相关的事物是什么	entity与什么有关	what
chairman	entity的主席是谁	entity的主席叫什么	who
ground	entity的地址在哪里	entity在哪儿	where
commonLanguages	entity的通用语言是什么	entity用什么通用语言	what
origin	entity的发源地在哪里	entity从哪里发源	where
currency	entity使用的货币是什么	entity用什么货币	what
children	entity的子女是谁	entity有哪些孩子	who
series	entity的所属系列是什么	entity属于哪个系列	what
職業	entity的职业是什么	entity做什么职业的	what
issue	entity的后裔是谁	entity有哪些后代	who
next	entity的下一位是谁	entity的下一位是哪个	who
postalCodeType	entity的邮政编码是什么	entity用什么邮政编码	what
eventStart	entity建立的起始事件是什么	entity建立的导火索	what
legislature	entity的立法机构是什么	entity由谁立法	what
succession	entity的立法机构是什么	entity由谁立法	what
titleLeader	entity领导者的头衔是什么	entity领导者的职称是什么	what
battles	entity参加的战争是什么	entity参加了什么战争	what
developer	entity的开发商是谁	entity是由谁开发的	who
民族	entity的所属民族是什么	entity属于哪个民族的	what
awards	entity获得的奖项是什么	entity获得了什么奖项	what
precededBy	entity的上一部作品是什么	entity是谁的下一部作品	what
currentclub	entity目前所属的俱乐部是什么	entity现在属于哪个俱乐部	what
manager	entity的经理是谁	entity由哪个经理领导	who
source	entity的来源是什么	entity来源于什么	what
leaderParty	entity的所属党派是什么	entity属于哪个党派	what
sport	entity从事的运动项目是什么	entity是做什么运动的	what
name	entity的名字是什么	entity被命名为什么	what
format	entity的形式是什么	entity是什么形式的	what
最大城市名稱	entity最大的城市是什么	entity最大的城市是哪里	where
keyPeople	entity的最重要的人物是谁	entity中谁最重要	who
languages	entity使用的语言是什么	entity用什么语言	what
seats1Title	entity属于什么	entity的出处是什么	what
deputy	entity的代理人是谁	entity的代理人是哪个	who
branch	entity的所属分支是什么	entity的分支是哪个	what
ideology	entity的意识形态是什么	entity属于什么意识形态	what
status	entity的身份是什么	entity是什么地位	what
貨幣單位	entity的货币单位是什么	entity用什么货币	what
era	entity的时代发生了什么战争	entity的时代有哪些战争	what
partof	entity是什么的一部分	entity是什么事件的一部分	what
district	entity所在的区域是哪里	entity在哪个区域	where
allegiance	entity效忠于谁	entity忠诚于谁	what
locale	entity的所属地点在哪里	entity在哪个地方	where
配偶	entity的配偶是哪位	entity的配偶是谁	who
order	entity的领导机构是什么	entity是属于哪儿的	what
nationalteam	entity所属国家队是什么	entity是哪个国家队的	what
commander	entity的将领是谁	entity由哪位将领领导	who
director	entity的导演是谁	entity是谁导演的作品	who
field	entity的领域是什么	entity属于哪个领域的	what
南	entity的南部是哪里	entity的南部水域叫什么	where
stadium	entity的举办地在哪里	entity在哪里举办的	where
consort	entity的配偶是哪位	entity的配偶是谁	who
monarch	entity的君王是谁	entity时期谁是国家君主	who
last	entity最后出自于哪儿	entity最后来自哪里	what
國家首都名稱	entity的首都是哪里	entity的首都在哪儿	where
team	entity的参赛队伍是谁	entity有哪些参赛队伍	who
manufacturer	entity的生产商是谁	entity是由哪个公司生产的	who
appointer	entity的任命者是谁	entity由谁担任	who
fam	entity的所属语系是什么	entity属于哪个语系	what
locationCity	entity的所在城市是哪个	entity在哪座城市	where
placeOfDeath	entity的逝世地是哪里	entity在哪里逝世的	where
语言	entity使用的语言是什么	entity说什么语言	what
result	谁是entity的获胜方	entity的胜利者是谁	who
family	entity的所属家族是什么	entity属于哪个家族	what
primeminister	entity的首相是谁	entity的国家首相叫什么	who
incumbent	entity的现任就职者是谁	entity现在由谁担任	who
官方文字	entity的官方语言是什么	entity官方用什么语言	what
官方語言	entity的官方语言是什么	entity官方用什么语言	what
語言	entity的语言是什么	entity用什么语言	what
parents	entity的父母是谁	entity是谁的孩子	who
ethnicity	entity的种族是什么	entity是哪个种族的人	what
國際域名縮寫	entity的国际域名缩写是什么	entity怎么缩写	what
constituencyWestminster	entity的选区是什么	entity是什么选区	what
states	使用entity的国家是什么	entity有哪些国家使用	where
royalHouse	entity的所属皇室	entity是哪个皇室的	what
政治體制	entity的政治体制是什么	entity采用哪种政治体制	what
publisher	entity的出版商是哪个	entity是哪个出版社的	what
countryofbirth	entity出生的国家是什么	entity在哪个国家出生的	where
influences	entity影响了谁	entity对谁产生了影响	who
burialPlace	entity的安葬地在哪里	entity被安葬在哪里	where
nickname	entity的绰号是什么	entity有什么绰号	what
prev	entity的前任是谁	entity的上一代是谁	who
clubs	entity的所在球队是什么	entity效力于哪个球队	what
西	entity西部是什么地方	entity西部的海洋叫什么	where
countryAdminDivisions	entity的隶属行政区是哪里	entity隶属于哪个行政区	where
producer	entity的制片人是谁	entity是谁制作的	who
influenced	受entity影响的人是谁	entity影响了谁	who
youthclubs	entity所属的青年俱乐部是哪个	entity属于哪个青年俱乐部	what
combatant	参与entity的国家有哪些	哪些国家在entity中参与了战争	who
start	entity的起点站是哪里	entity始于哪个站	where
東	entity东部是什么地方	entity东部的海洋叫什么	where
東北	entity东北部是什么地方	entity东北部的地方叫什么	where
network	entity是哪个网络的	entity属于什么网络	what
seats3Title	entity属于哪里	entity位于地方名称	what
birthplace	entity是来自哪里	entity出自哪里	where
上一節目	entity的上一个节目是什么	entity是谁的下一个节目	what
largestCity	entity最大的城市是什么	entity中哪个城市最大	where
seats2Title	entity所属名称是什么	entity的出处是什么	what
下一節目	entity的接档节目是什么	entity播完之后播什么	what
artist	发布entity的艺人是谁	entity是谁的作品	who
placeOfBurial	entity的安葬地在哪里	entity被安葬在哪里	where
designer	entity的设计者是谁	entity是谁设计的	who
creator	entity的创造者是谁	entity是谁创造的	who
instrument	entity使用的乐器是什么	entity用的是什么乐器	what
starring	entity的主演是谁	entity是谁主演的	who
locationCountry	entity在哪个国家	entity是哪个国家的	where
affiliation	entity的隶属机构是什么	entity隶属于哪个机构	what
affiliations	entity的附属机构是什么	entity附属于哪个机构	what
北	entity的北部城市是什么	entity的北部有什么城市	where
nation	entity的所属国家是什么	entity属于哪个国家	where
writer	entity的作者是谁	entity是谁写的	who
architect	entity的建筑师是谁	entity是谁参与建筑的	who
garrison	entity驻守的区域是哪里	entity在哪里驻守	where
教育程度	entity的毕业学校是哪里	entity在哪所学校毕业的	where
college	entity就读的大学是哪里	entity读的哪所大学	where
rank	entity的职级是什么	entity是什么级别的	what
subdivisionRanks	entity的分类等级是什么	entity属于什么分类等级	what
出生地	entity的出生地在哪里	entity在哪里出生的	where
西北	entity西北部是什么地方	entity西北部的区域叫什么	where
areas	entity产生的区域是哪里	entity在哪里产生	where
coach	entity的教练是谁	entity是哪个教练带的	who
education	entity的毕业院校是哪里	entity在哪里毕业的	where
constituency	entity的选民来自哪里	entity的选民出自哪里	where
profession	entity的专业是什么	entity是什么专业的	what
父親	entity的父亲是谁	entity的爸爸叫什么	who
discoverySite	entity的发现地区是哪里	entity在哪里被发现的	where
mapCaption	entity的标志性地点是哪里	entity有什么标志性的地点	where
shireCounty	entity的是哪个郡的	entity属于哪个郡	where
西南	entity的西南方是哪里	entity的西南边有什么城市	where
tenants	entity的佃户是谁	entity被谁租用	who
archipelago	entity的所属海域是哪里	entity属于哪片海域	where
honorificSuffix	entity是属于哪里的	entity是就职于哪里	what
draftTeam	entity的选秀队伍是什么	entity是哪个选秀队伍的	what
body	entity就职于哪里	entity是属于哪里的	what
