title	entity的头衔
before	entity的上一代
after	entity的继任者
location	entity的位置
birthPlace	entity的出生地
predecessor	entity的前任
caption	entity的代表
region	entity所属的区域
north	entity北部的地点
subdivisionType	entity的所属区划
west	entity西部的地点
type	entity的类型
deathPlace	entity逝世的地方
east	entity东部的地点
successor	entity的继任者
southwest	entity西南部的地点
southeast	entity东南部的地点
shipNamesake	entity的同名之人
south	entity南部的地点
seat	entity的行政中心
country	entity的所属国家
northeast	entity东北部的地点
owner	entity的拥有者
northwest	entity西北部的地点
founder	entity的开国皇帝
city	entity的所在城市
name	entity著名的人
source	entity的信息来源
operator	entity的运营方
leader	entity的领导人
religion	entity的信仰宗教
state	entity的所在州
event	entity的事件
venue	entity的举办地
headquarters	entity的总部地址
next	entity的下一任
imageCaption	entity的代表
postalCodeType	entity的邮政编码类型
logo	entity的logo图片
house	entity的所属王朝
issue	entity的后裔
honorificSuffix	entity的敬语后缀
place	entity的举办地
namedFor	entity的命名来源
s	entity附近的城市
legislature	entity的立法机构
stadium	entity的举办地
namedAfter	entity是以谁命名的
team	entity的参赛队伍
first	entity的第一人
status	entity的政治类型是什么
blankName	entity的驾驶证类型
format	entity的格式
eventEnd	entity的原因
organization	entity的所属组织
honorificPrefix	entity的敬语前缀
blankNameSec	
eponym	entity的命名者
residence	entity的居住地
province	entity的所在省份
party	entity的所属党派
district	entity的所属区域
style	entity的类型
almaMater	entity的母校
proteam	entity的专业队伍
chieftown	entity的镇长
family	entity的所属系列
sport	entity从事的运动
sponsor	entity的赞助商
coach	entity的教练
areaCodeType	entity电话所属国家
label	entity的标签
countryAdminDivisions	entity的隶属行政区
source1Location	entity的发源地
appointer	entity的任命者
town	entity的所属城镇
origin	entity的起源
previous	entity的前身
hqLocationCity	entity的所在城市
succession	entity的继任者
spouse	entity的配偶
league	entity效力的联赛
manager	entity的管理者
author	entity的作者
seats1Title	entity的头衔
years	entity年代的人
eventStart	entity建立的起始事件
data	entity的城市
series	entity的所属系列
commonLanguages	entity的通用语言
theme	entity的主题
diocese	
tenants	entity的租客
mother	entity的母亲
president	entity效力的总统
notableWorks	entity的著作
seatType	entity的类型
titleLeader	entity领导者的头衔
workplaces	entity的工作地
state/province	entity的所在省份
beforeElection	entity之前选举的获胜者
partof	entity的所属地
related	entity的相关事物
capital	entity的首都
captain	entity的队长
founders	entity的创始人
burialPlace	entity的安葬地
establishedTitle	entity的权力
blankInfo	entity的气候
club	entity俱乐部地点
e	entity的所在城市
blank1InfoSec	entity的交流语言
designer	entity的设计者
education	entity的毕业院校
teams	entity的所属队伍
establishedEvent	entity建立的标志事件
afterElection	entity的选举获胜者
division	entity的总队
nationality	entity的国籍
home	entity的主场
writer	entity的作者
affiliation	entity的隶属机构
ethnicity	entity的种族
language	entity的交流语言
namesake	entity的同名
seats2Title	entity的所属机构
studio	entity的所属电影公司
era	entity的时代
etymology	entity的词源
subject	entity的学科
parent	entity的父本
department	entity的所属部门
sign	entity的签名形式
last	entity的最后任
manufacturer	entity的生产商
w	entity西部的城市
n	entity北部的城市
nominator	entity的提名者
denomination	entity的面值
position	entity的定位
incumbent	entity的现任就职者
stateParty	entity的执政地
partsType	entity的部分所属
start	entity起始时间
cctld	entity的域名
parents	entity的父母
college	entity加入的社团
leader1Name	entity的领导者
blank1NameSec	
host	entity举办于
architect	entity的建筑师
locale	entity的所属地点
nw	entity内地方
text	entity相邻于
precededBy	entity先前地方
round	entity曾参赛
area	entity出现区域
municipality	entity的自治区
dedication	entity位于
other	entity的别称
regent	entity的统治者
1namedata	entity的别名
workInstitutions	entity的工作机构
developer	entity的开发者
chronology	entity的创作者
hqLocationCountry	entity的城市
awardedBy	entity的授予单位
inaugural	entity的首任
story	entity的作者
music	entity的创造者
creator	entity的创造者
genre	entity的类型
extra	entity出现过
artist	entity的艺术家
alongside	entity扮演过
father	entity的父亲
basedOn	entity基于
controlledby	entity的控制者
client	entity的当事人
dynasty	entity的所属帝国
target	entity的适用病
lyrics	entity的作词者
premier	entity的省总理
publisher	entity的出版商
usedBy	entity被使用的地方
workInstitution	entity的工作机构
deputy	entity的副手
primaryUser	entity的主要使用者
as	entity被列入
preceded	entity的前一代
appointed	entity的任命
subdivision	entity的所在的国家
children	entity的下一代
candidate	entity的候选
officiallyOpenedBy	entity的官方举办者
countriesAffected	entity影响城市
body	entity属于哪里
county	entity的所属城市
blank2InfoSec	entity的人
ancestry	entity的祖国
