title	entity的头衔是什么	entity具有哪些头衔	what
before	entity的前任是什么	entity的上一代是什么	what
after	entity的继任者是哪位	entity是谁的上一任	who
location	entity在什么位置	entity在哪儿	where
birthPlace	entity的出生地是哪里	entity在什么地方出生的	where
predecessor	entity的前一任是谁	entity是谁的继任者	who
caption	entity的代表是什么	entity有什么代表	what
region	entity所属的区域是哪里	entity在属于什么区域	where
north	entity北部是什么地方	entity北部的省份叫什么	where
subdivisionType	entity的区划是什么	entity属于哪个区划	where
west	entity西部是什么地方	entity西边的地方叫什么	where
type	entity的类型是什么	entity属于什么类型	what
deathPlace	entity逝世的地方是哪里	entity在哪里逝世的	where
east	entity东部是什么地方	entity东边的地方叫什么	where
successor	entity的继任者是哪位	entity是谁的上一任	who
southwest	entity西南部是什么地方	entity西南边的地方叫什么	where
southeast	entity东南部是什么地方	entity东南边的地方叫什么	where
shipNamesake	entity的同名是什么	entity又叫什么	what
south	entity南部是什么地方	entity南边的海洋叫什么	where
seat	entity的行政中心在哪里	entity的省会是哪里	where
country	entity的所属国家是什么	eneity在哪个国家	where
northeast	entity东北部是什么地方	entity东北边的海洋叫什么	where
owner	entity的拥有者是谁	entity被谁管理	who
northwest	entity西北部是什么地方	entity西北边的海洋叫什么	where
founder	entity的开国皇帝是谁	entity是谁创始的	who
city	entity所属城市是哪里	entity在哪个城市	where
name	entity以什么著名	entity有什么著名的人	who
source	entity的信息来源于谁	谁预言过entity的相关信息	who
operator	entity的运营方是谁	entity是由谁运营的	who
leader	entity的皇帝是谁	谁是entity的皇帝	who
religion	entity的信仰宗教是什么	entity信仰哪个宗教	what
state	entity所在的州是哪里	entity在哪个州	where
event	entity发生了什么事件	entity有哪些事件	what
venue	entity的举办地在哪里	entity在哪个国家举办的	where
headquarters	entity的总部在哪里	entity的总部地址是哪里	where
next	entity的下一任是谁	entity的继任是谁	who
imageCaption	entity的代表是什么	entity有什么代表	what
postalCodeType	entity的邮政编码类型是什么	entity的邮政编码怎么写	what
logo	entity的logo是什么样子的	entity的logo长什么样	what
house	entity所属的王朝是什么	entity属于哪个王朝	what
issue	entity的后裔是谁	entity有哪些后代	who
honorificSuffix	entity的敬语后缀是什么	entity就职于哪个机构	what
place	entity的举办地在哪里	entity在哪个国家举办的	where
namedFor	entity的名字来源于谁	entity是以谁的名字命名的	what
s	entity附近有什么城市	entity周边有什么城市	where
legislature	entity的立法机构是什么	entity由谁立法	who
stadium	entity的举办国是谁	entity在哪里举办的	where
namedAfter	entity的名字来自哪里	entity的名字来源于哪里	what
team	entity的参赛队伍是谁	entity有哪些参赛队伍	who
first	entity的第一任是谁	entity的第一个人叫什么	who
status	entity的政治类型是什么	entity是什么类型的国家	what
blankName	entity开车需要哪里的牌照	entity考的是哪里的驾照	what
format	entity的格式是什么	entity转换为什么格式	what
eventEnd	entity是什么的结果	entity是怎么来的	what
organization	entity的所属组织是谁	entity属于哪个组织	who
honorificPrefix	entity的敬语前缀是什么	如何尊称entity	how
blankNameSec			
eponym	entity的命名者是谁	entity是以谁命名的	who
residence	entity的居住地在哪里	entity住过的地方有哪些	where
province	entity的所在的省份是哪里	entity在哪个省	where
party	entity所属的党派是什么	entity属于哪个党派	what
district	entity所在的区域是哪里	entity在哪个区域	where
style	entity的类型是什么	entity属于什么类型	what
almaMater	entity的母校是什么	entity的母校叫什么	what
proteam	entity的专业队伍是什么	entity是哪支专业队伍的	what
chieftown	entity的镇长是谁	entity的镇长叫什么名字	who
family	entity的所属系列是什么	entity属于哪个系列	what
sport	entity从事的运动项目是什么	entity是做什么运动的	what
sponsor	entity的赞助商是哪个公司	entity是由谁赞助的	who
coach	entity的教练是谁	entity是哪个教练带的	who
areaCodeType	entity是哪里的电话号码	entity的电话号码是哪个国家的	what
label	entity的标签是什么	entity有什么标签	what
countryAdminDivisions	entity的隶属行政区是哪里	entity隶属于哪个行政区	where
source1Location	entity的发源地是哪里	entity发源于哪里	where
appointer	entity的任命者是谁	entity由谁担任	who
town	entity的所属城镇是哪里	entity在哪个城镇	where
origin	entity的起源在哪里	entity从哪里起源	where
previous	entity的前身是什么	entity之前的机构叫什么	what
hqLocationCity	entity所在的城市是哪里	entity在哪座城市	where
succession	entity的继任者是哪位	entity的下一任是谁	who
spouse	entity的配偶是哪位	entity的配偶是谁	who
league	entity效力的联赛是哪个	entity效力于哪个联赛	what
manager	entity的管理者是谁	entity由谁在管理	who
author	entity的作者是谁	entity是谁写的	who
seats1Title	entity的头衔是什么	entity具有哪些头衔	what
blankInfoSec	entity有哪些著名的人物	entity是谁的出生地	who
years	entity的年代有谁	entity的年代还有什么人	who
eventStart	entity建立的起始事件是什么	entity建立的导火索	what
data	entity有什么城市	entity有哪些城市	what
series	entity的所属系列是什么	entity属于哪个系列	what
commonLanguages	entity用什么通用语言交流	entity说什么通用语言	what
theme	entity的主题是什么	entity是什么风格的	what
diocese	entity的所属教区是什么	entity属于哪个教区	
tenants	entity的佃户是谁	entity被谁租用	who
mother	entity的母亲是谁	entity的妈妈叫什么	who
president	entity效力的总统是谁	entity为哪个总统效力	who
notableWorks	entity的著名作品有什么	entity有什么出名的作品	what
seatType	entity的类型是什么	entity属于什么类型	what
titleLeader	entity领导者的头衔是什么	entity领导者的职称是什么	what
workplaces	entity工作的地方是哪里	entity在哪里上班	where
state/province	entity所在的省是哪里	entity在哪个省	where
beforeElection	entity之前的选举获胜者是谁	entity之前是谁赢得选举的	who
partof	entity是什么的一部分	entity是什么地方的一部分	where
related	同entity相关的事物是什么	entity与什么有关	what
capital	entity的首都是哪里	entity的首都在哪儿	where
captain	entity的队长是谁	entity是谁带领的	who
founders	entity的创始人是谁	entity是谁创始的	who
burialPlace	entity的安葬地在哪里	entity被安葬在哪里	where
establishedTitle	entity拥有什么权力	entity的所有权是什么	what
blankInfo	entity的气候是什么	entity的气候怎么样	what
club	entity俱乐部位于哪里	entity的总部在哪里	where
e	entity在哪座城市	entity在哪里	where
blank1InfoSec	entity用什么语言交流	entity说什么语言	what
designer	entity的设计者是谁	entity是谁设计的	who
education	entity的毕业院校是哪里	entity在哪里毕业的	where
teams	entity的所属队伍是哪个	entity属于哪个队伍	who
establishedEvent	entity建立的标志事件是什么	entity是由哪个事件决定的	what
afterElection	entity最终获胜者是谁	entity赢得选举的人是谁	who
division	entity是谁的创始球队	entity是由谁细分出来的	what
nationality	entity的国籍是什么	entity是哪个国家的	what
home	entity的主场在哪里	entity在哪里进行的	where
writer	entity的作者是谁	entity是谁写的	who
affiliation	entity的隶属机构是什么	entity隶属于哪个机构	what
ethnicity	entity的种族是什么	entity是哪个种族的人	what
language	entity用什么语言交流	entity说什么语言	what
namesake	entity的同名是什么	entity又叫什么	what
seats2Title	entity属于哪个机构	entity的席位是什么机构的	what
studio	entity属于哪个电影公司	entity所属的电影公司是哪个	who
era	entity的时代是什么时候	entity是哪个时代的	when
etymology	entity的词源是什么	entity源于什么词源	what
subject	entity的学科是什么	entity主修什么	what
parent	entity的父本是什么	entity的亲本是哪里	where
department	entity的所属部门是什么	entity属于哪个部门	what
sign	entity签名形式是什么	entity用什么形式来签名	what
last	entity的最后一任是谁	entity的最后一任叫什么	who
manufacturer	entity的生产商是谁	entity是由哪个公司生产的	who
w	entity西部的城市有哪些	有哪些城市在entity的西部	where
n	entity北部的城市有哪些	有哪些城市在entity的北部	where
nominator	entity的提名者是什么	谁提名了entity	who
denomination	entity的面值叫做什么	entity的面值由什么得来	what
position	entity的定位是什么	entity有什么定位	what
incumbent	entity的现任就职者是谁	entity现在由谁担任	who
stateParty	entity执政于什么地方	entity是哪里的政党	what
partsType	entity部分所属于什么	entity的部分所属是什么	what
start	entity始于什么时候	entity从什么时候开始的	when
cctld	entity的顶级域名是什么	entity的域名叫什么	what
parents	entity的父母是谁	entity是谁的孩子	who
college	entity参加过的社团是什么	entity曾经加入过什么社团	what
leader1Name	entity领导者的名字是	entity的领导者叫什么	who
blank1NameSec			
host	entity在哪里被举办	entity举办于什么地方	where
architect	entity的建筑师是谁	entity是谁参与建筑的	who
locale	entity的所属地点在哪里	entity在哪个地方	where
nw	entity的有什么地方	entity内有什么地点	what
text	entity与什么相邻	entity的边界相接于谁	what
precededBy	entity先前于什么地方	entity的之前是什么地方	what
round	entity环绕过哪里	entity在哪里打过比赛	what
area	entity出现在哪里区域	entity在什么地方出现的	where
municipality	entity是属于哪个自治区的	entity是位于哪个自治区的	what
dedication	entity位于哪里	entity是在哪里的	where
other	entity又叫做什么	entity又被成为什么	what
regent	entity的统治者是谁	entity由谁统治	who
1namedata	entity的别名叫什么	entity又叫做什么	what
workInstitutions	entity的工作机构叫什么	entity在哪里工作	where
developer	entity的开发者是谁	entity是谁开发的	who
chronology	entity的作者谁	entity由谁创作	who
hqLocationCountry	entity位于哪里	entity位于哪座城市	where
awardedBy	entity的授予单位是什么	entity是由谁授予的	what
inaugural	entity的首任是谁	entity的第一位是谁	who
story	entity由谁书写	entity的作者是谁	who
music	entity是谁的音乐	entity的创造者是谁	who
creator	entity的创造者是谁	entity是谁创造的	who
genre	entity的类型是什么	entity是什么类型的	what
extra	entity曾出现过谁	entity上谁上场过	who
artist	entity的艺术家是谁	entity的艺术家叫什么	who
alongside	entity曾扮演过谁	entity曾以什么身份出现	who
father	entity的父亲是谁	entity的爸爸是谁	who
basedOn	entity在哪里被举办	entity在什么上举办的	what
controlledby	entity曾被谁控制	entity曾属于哪里	who
client	entity的当事人是谁	entity的主理人叫什么	who
dynasty	entity是哪个帝国的朝代	entity属于哪个帝国	what
target	entity针对什么病	entity是治什么病的	what
lyrics	entity的作词者是谁	entity的词是谁写的	who
premier	entity的省总理是谁	entity的首相叫什么	who
publisher	entity的出版商是哪个	entity是哪个出版社的	what
usedBy	entity曾被哪里使用	entity在哪里被用过	where
workInstitution	entity工作的地方是哪里	entity工作地方叫什么	what
deputy	entity的副手是什么	entity的副手被称为什么	what
primaryUser	entity的主要使用者是谁	entity主要由谁使用	who
as	entity被列入过什么	entity曾经被加入过什么	what
preceded	entity的前一代是谁	entity是在谁之前	who
appointed	entity被任命为什么	entity被任命过什么	who
subdivision	entity隶属于哪里	entity在哪个国家	where
children	entity的下一代是什么	entity的后代是什么	what
candidate	entity是什么的候选人	entity当过什么候选	what
officiallyOpenedBy	entity的官方举办者是谁	entity是由谁官方举办的	who
countriesAffected	entity影响到了什么城市	entity对哪些城市有影响	what
body	entity属于哪里	entity是哪里的	what
county	entity的所属城市是什么	entity属于什么城市	what
blank2InfoSec	entity的著名人物有谁	entity有哪些人	who
ancestry	entity的祖先来自哪个国家	entity是哪国人	where
