éditeur	entity的编辑是谁	谁作为编辑出品了entity	who
auteur	entity的作者是谁	谁是entity的作者	who
lieu	entity的位置在哪里	entity在什么位置	where
prédécesseur	entity继任了谁	谁是entity的前任	who
subdivision	entity的行政分区是什么	entity属于哪个行政分区	where
siège	entity的总部在哪里	entity把总部设立在哪里	where
avant	entity的上一任是谁	entity前一任叫什么名字	who
successeur	entity的继任者是谁	entity的下一任是谁	who
région	entity的分布区域是什么	entity分布于什么区域	where
type	entity是什么类型	entity的类型叫什么	what
nom	entity的名字在哪里	entity的名字存放于哪里	where
après	entity的下一任是谁	entity的继任者是什么人	what
ville	entity的所属州是什么	entity所属的州在哪里	where
titre			
lieuDeNaissance	entity出生在哪里	entity出生的地方叫什么名字	where
liste	entity在哪个列表中	entity在什么列表中	what
site	entity出现在哪里	entity可以在哪里看到	where
fonction	entity的职位在哪里能看到	entity的职位在什么地方	what
président	entity的总统是谁	entity效力的总统叫什么	who
propriétaire	entity的营运方是什么	谁负责entity的营运	who
langue	entity的语言是什么	entity使用的语言有哪些	what
légende	entity的传奇叫什么名字	entity的传奇是什么	what
lieuDeDécès	entity的死亡地点在哪里	entity在什么地方死亡	where
capitale	entity是什么的首都	entity属于哪里的首都	where
pays	entity属于哪个国家	entity在什么国家里面	where
localisation	entity的所在地在哪里	在哪里能找到entity	where
précédent	entity前任是谁	entity的上一任叫什么名字	who
suivant	entity的下一位是谁	谁是entity之后的下一位	who
nomDeDivision	entity所在的大区是什么	entity属于什么大区	where
périodique			
commune	entity所在的直辖市是什么	entity在哪个直辖市	where
division	entity所在的地区是哪里	entity在哪个地区	where
origine	entity的起源是什么	entity的开端是什么	what
préface			
équipementSportif	entity的主场是什么	entity的主场场馆是什么	what
lienSubdivision	entity所在的地区是什么	entity在哪个地区	where
province	entity在哪个省	entity是哪个省的	where
club	entity是哪个俱乐部的	entity所在的俱乐部叫什么名字	who
chefLieu	entity的行政中心是哪里	entity的行政中心叫什么	where
tenant	entity的参赛球队是哪些	entity的参赛球队都叫什么	who
premTitulaire	第一任具有entity头衔的人是谁	谁担任了第一任entity	who
gouvernement	entity为哪个政府效力	entity效力的政府是哪个	what
affiliation	entity所隶属的组织是什么	entity隶属于哪里	what
ouest			
état	entity在哪个州	entity所在的州是什么	where
palmarèsNational	entity在什么比赛中拿到全国前十名	entity得到全国第十名的比赛叫什么	what
stade	entity的主场是什么	entity的体育场是哪个	what
nomCapitale	entity的首都是什么	entity的首都在哪里	where
constructeur	entity的设计者是谁	entity的设计者叫什么名字	who
est	entity的东部是哪里	entity的东部叫什么名字	where
quartier	entity是哪里的街区	entity属于什么街区	where
sud	entity的南部是什么	在entity的南边是啥	what
fondateur	entity的创始人是谁	entity的创建者叫什么名字	who
nordEst	entity的东北部是哪里	entity的东北部叫什么名字	where
premierMinistre	entity的总理是谁	entity的总理是哪位	who
nord	entity的北面是哪里	entity的北面叫什么名字	where
embouchureLocalisation	entity的河口位置处有什么	entity的河口位置叫什么	what
nordOuest	entity的西北部有什么	entity的西北部是哪里	where
championnatActuel	entity是什么联赛的本届冠军	entity是哪里的本届冠军	what
situation	entity的位置在哪里	entity属于哪里	where
parti	entity的党派是什么	entity选择了什么党派	what
lienRégion	entity的关联区域是哪里	entity的关联区域叫什么	what
sudEst	entity的东南部有什么	entity的东南部存在着什么	what
précédente	entity上一个是什么	entity前一个是什么	what
sudOuest	entity的西南区是哪里	entity的西南区叫什么名字	where
équipe	entity所属队伍是什么	entity是哪个队伍的	what
monarque	entity的君主是谁	entity的君主叫什么名字	who
bassinCollecteur	entity的河口(入海口)是什么	entity的流入哪里	where
sépulture	entity安葬在哪里	entity是在哪里安葬的	where
plusTitré			
entraîneur	entity的教练是哪个人	entity的教练叫什么名字	who
nationalité	entity的国籍是什么	entity的哪个国家的人	what
valeur			
langues	entity用什么语言	entity用的语言叫什么	what
législature	entity的立法机构叫什么	entity在哪里办公	what
conjoint	entity与谁相连	entity的共同利害关系人是谁	who
commandant	entity的指挥官是谁	entity的指挥官叫什么名字	who
titulaireActuel	现任entity的名字叫什么	谁是现任entity	who
portD'attache	entity的母港是哪个	entity的母港在哪里	where
comté	entity是哪里的郡	entity属于哪里	where
commanditaire	entity的资金提供者是谁	entity是由谁出资建造的	who
collection			
éponyme	entity是谁命名的	entity的名字是谁取的	who
pointCulminant			
régime	entity的流动方式与什么有关	entity的流动方式依靠什么	what
hiérarchie+_	entity的高一等级是啥	比entity高一级的是什么	what
combattants	entity的战士是谁	entity的战斗人员叫什么名字	who
leadera	entity的领袖是谁	entity的管理者是谁	who
ligue	entity所属联盟是什么	entity在哪个联盟	who
catégorie	entity的类别是什么	entity属于什么种类	what
subdivisionsTerritoriales	entity属于哪里	entity是哪里的领土	where
paysDeNaissance	entity出生国是哪里	entity来自哪里	where
nomDeCode	entity的代码名称是什么	entity的代码名称是怎样的	what
siège(ville)_	entity的总部在哪里	entity坐落于哪里	where
coalition	entity的联盟是什么	entity与谁同盟	who
finaliste	entity的决赛队伍叫什么	entity的决赛队伍有哪个	who
district	entity位于哪里	entity被划分在哪里	where
titreLeadera	entity的领导人头衔是什么	entity的领导人被称为什么	what
suivante	entity后面的是谁	entity的下一位是谁	who
adresse	entity的地址在哪里	entity的位置在哪	where
lieuOrigine	entity来源于哪里	entity是从哪里发源的	where
lieuDeVénération	entity的所在地叫什么	entity地点来源在哪里	where
subdivision1Type			
intituléSubdivision	entity的行政区划分是什么	entity的行政区怎么划分的	what
chef	entity的领导者是谁	entity的长官是谁	who
gouverneur	entity的领导叫什么名字	entity的上司是谁	who
sel			
auteurs	entity由谁创造的	entity的创造者叫什么	who
autoritéUnitaire	entity的单一管理区有哪些	哪些地区是entity的单一管理区	where
palmarèsInternational	entity赢得的国际比赛是哪个	entity赢得了什么国际赛事	what
exploitant	entity的运营方是谁	entity由谁经营	who
genre	entity的种类是什么	entity是哪种类型的	what
statut	entity的业务类型是什么	entity提供哪种业务类型	what
parlement	entity的议会是什么	entity的议会叫什么	what
sexe	entity是什么性别	entity是男的还是女的	what
équipeNfl	entity效力的球队是什么	entity效力于什么球队	what
villeDepart	entity从哪里出发	entity的第一站是哪里	where
début	entity在哪里起始	entity的起始位置是什么地方	what
paysDeDécès	entity是在哪个国家逝世的	entity的离世之地是什么地方	where
villesPrincipales	entity的主要城市是什么	哪些是entity的主要城市	where
destination	entity的终点站是哪里	entity的目的地是哪里	where
coupe	entity的杯赛冠军是什么	谁获得了entity的杯赛冠军	where
clubJunior	entity参与的青年俱乐部是什么	entity参与了什么青年俱乐部	where
lanceur	entity的发射手段是什么	entity使用的是什么发射手段	what
typeSubdivision	entity的区域类型是什么	entity属于什么区域类型	what
mandant	entity的任命者是谁	entity由什么人任命	who
famille	entity所属的家族是什么	entity属于什么家族	what
lieuparutionOrig	entity的发行地是哪里	entity在哪里发行	where
champion	entity的冠军是谁	entity的冠军获得者叫什么	who
capitaine	entity的队长是谁	entity的队长叫什么名字	who
activités	entity的知名活动是什么	entity所知名领域是什么	what
groupeParlementaire	entity的议会小组叫什么	entity所属哪一个议会小组	what
hiérarchie	entity的等级制度是什么	entity属于什么等级制度	what
créateur	entity的创造者是谁	entity由什么人创造	who
porteDrapeau	entity的旗手是谁	entity的旗手叫什么名字	who
mission	entity参与了什么任务	entity参与的任务是什么	what
partiSuccesseur	entity的胜选党派是什么	entity的胜选方是什么	what
vainqueur	entity的优胜者是谁	entity的优胜者叫什么名字	who
villeArrivee	entity的终点是什么地方	entity的终点在哪里	where
villes	entity的主要城市是哪些	entity有哪些主要城市	what
organisation	entity的组织机构是什么	entity由什么组织管理	what
département	entity在什么区	entity所在的区是什么	where
franchit	entity跨域了什么	entity跨越的水域是什么	what
père	entity的父亲是谁	entity的父亲叫什么名字	who
dr	entity的分布区域是什么	entity的区域分布是哪些	what
deuxième	entity的亚军是哪支队伍	哪支队伍获得了entity的亚军	who
territoire	entity的领地在哪里	哪里属于entity的领地	where
chaîne	entity由谁播出	播出entity的媒体是什么	what
modèlePrécédent	entity的上一个模型是什么	entity的前身是什么	what
usine	entity的工厂在哪里	entity是在哪里生产的	where
sociétéSœur	entity的姐妹公司是什么	entity有哪些姐妹公司	what
massif	entity所在的山脉是什么	entity与什么山脉关联	what
modèleSuivant	entity的下一个模型是什么	entity的下一个产品是什么	what
couleurs	entity的标志颜色是什么	entity标志的颜色叫什么	what
cible	entity的目标是谁	谁是entity的目标	who
nomSubdivisionMère	entity的子区是哪些	entity的子区包含什么地方	where
découvreur	entity的发现者是谁	entity的被谁发现的	who
fratrie	entity的兄弟是谁	entity的兄弟叫什么名字	who
marque	entity的品牌是什么	entity是什么牌子的	what
voirAussi			
sport	entity的主要运动项目是什么	什么体育运动在entity受到关注	what
lang	entity的官方语言是什么	entity主要讲什么语言	what
allégeance	entity为谁效忠	entity效忠的对象是谁	who
chantier	entity的制造工厂是什么	哪家工厂负责entity的制造	where
série			
développeur	entity由谁负责开发	entity的开发商是哪个	who
dynastie	entity的朝代是什么	entity所在的王朝是什么	when
concepteur	entity的设计者是谁	entity的设计师叫什么名字	who
saisonPrécédente	entity的上一季是什么	entity的第一季是什么	what
œuvre	entity是谁的作品	entity在谁的作品中出现	who
saisonSuivante	entity的下一季是什么	entity的第三季叫什么名字	what
vicePrésident	entity的副主席是谁	谁为entity担任副主席	who
franchise	entity的特许经验方是谁	谁是entity的特许经营方	who
chaine	entity的传播媒体是什么	entity由哪家媒体播出	what
origineNom	entity的命名依据是什么	entity依据什么而命名	what
artiste	entity的艺术家是谁	哪位艺术家建立了entity	who
formation	entity就读于哪所学校	entity在哪些学校就读过	what
armateur	entity的船主是谁	entity的船东是谁	who
précédéPar	entity之前是什么	entity的上一代是什么	what
présentation	entity的主持人是谁	谁负责主持entity	who
fabricant	entity的厂商是谁	entity的制造商是谁	who
leader	entity的领袖是谁	entity的掌权者叫什么名字	who
partiPrédécesseur	entity的前身党是谁	entity的前身党叫什么	what
réalisateur	entity的导演是谁	entity的导演叫什么名字	who
titreDeLaSérie	entity的系列标题是什么	entity的系列标题叫什么	what
mère	entity的母亲叫什么名字	entity的生母是谁	who
plusGrandeVille	entity最大的城市是什么	entity最大的城市叫什么名字	what
traducteur	entity的译者是谁	谁负责翻译了entity	who
versionPrécédente	entity的早期版本是什么	entity的早期版本叫什么名字	what
drapeauLien	entity的标志什么	entity的标志叫什么	what
compagnie	entity的公司是什么	entity的公司叫什么	what
fusionnéDans	entity与谁合并了	entity的合并对象谁	who
suiviPar	entity下一季是什么	entity续作是什么	what
organisateur	entity的组织方是谁	entity的组织方叫啥	who
résidenceOfficielle	entity的官邸是什么	entity的官邸的名称是什么	what
localité	entity的位置在哪里	在哪能找到entity	where
stationSuivante	entity的下一站是哪里	entity的下一站叫什么名字	what
leaderc	entity的领导是谁	entity的领袖叫什么名字	who
héritier	entity的继承人是谁	entity的下一任是谁	who
featuring	entity的创作者是谁	谁创作了entity	who
